
R 1500 1500
SO./images/brick3.XPM
WE./images/brick2.XPM
NO./images/brick.XPM 
EA./images/wood.XPM                   
S ./images/barrel.XPM
F     10,       150,            60                  
C     101          ,50     ,              150                                             

111111111111111111111111111111111111111111111111111111111111111111111111
100000000000000000000000000000000000000000000000000000000000000000000001
100000000000000000000000000000000000000000000000000000000000000000000001
100000000000000000000000000020000000000000000000000000000000000000000001
100000000000000000000000000000000000000100000000000000000000000000000001
100000000000000111111000000000000000001210000000000000000000000000000001
100000000000000000000000000000000000000000000000000000000000000000000001
100000000000000000000000000020000000000000000000000000000000000000000001
100000000000000000000000000000000000000000000000000000000000000000000001
100000000000000000000000000000000000000100000000000000000000000000000001
100000000000000000000000000000000000000000000000000000000000000000000001
100000000000000000000000000000000000002000000000200000000000000000000001
10000000000000000000E000000000000000000000000000000000000000000000000001
111111111111111111111111111111111111111111111111111111111111111111111111




